32 18 1
0
00000000000000044444444444400000
00000000000000440000000000000000
44444444444444000000000000000300
00000000000000000000000000000000
00000000000000000000000000000010
00000000000000000000000000000010
00000000000000000000000000000110
00000000000000000000000000011110
00000000000000000000000000111110
00000000000000000000000111111100
00000000000000000000111100000000
00200000000000000011100000000000
00000000000000001110000000000000
00000000000000001000000000000000
00011111111111111000000000000000
00000000000000000000000000000000
00000000000000000000000000000000
00000000000000000000000000000000
