30 15
130000000000000000000000000000
100000000000000000000000000000
110000000000001100000000000000
111100111110011111100111100000
000000000000000000000000110000
000000000000000000000000000011
000000000000000000000000000000
000000000000000000000000001100
200000000000000000000001100000
000000000000000000000000000000
111111111000001111001110000000
000000001100011000000000000000
000000001111110000000000000000
000000000000000000000000000000
000000000000000000000000000000
