32 18 1
0
00000000000000000000000000000000
00000000000000000000000000000000
00000000000000000000000000000000
00000000000000000000000000000000
00000000000000000000000000000000
00000000000000000000000000000000
00000000000000000000000000000000
00000000000000040000000000000000
00000000000000000000000000000000
00000040000000000000000000000000
00000000000000000000000000000000
00200000000000111000000000000300
00000000000000101000000000000000
01111111111111111111111111111110
00000000000000000000000000000000
00000000000000000000000000000000
00000000000000000000000000000000
00000000000000000000000000000000
