32 18 1
0
00000000000000000000000000000000
00000000000000000000000000000000
00000000000000000000000000000000
00000000000000000000000000000000
00000000000000000000000000000000
00000000000000000000000000000000
00000000000000000000000000000000
00000000000000000000000000000000
00000000000000000000000000000000
01111111111111111111111111111110
01111111111111111111111111111110
01111111111111111111111111111110
00000000000000000000000000400000
02000000040000000000000000000030
00000000000000000000000000400000
01111111111111111111111111111110
01111111111111111111111111111110
01111111111111111111111111111110
