32 18 1
0
00011441100000000000001110000000
00011441100000000000001110000000
00011001100000000000001110000000
00011001100000000000001110000000
00011001100000000000001110000000
00011001100000000000001110000000
00011001100000000000001110000000
00011001100000000000001110000000
00011001100000000000001110000000
00011001100000000000001110000000
11111001111111111111111111111111
11111001111111111111111111111111
10000000000000000000000000000001
10200000000000000000000000000001
10000000000000000000000000000001
11111001111111111111111111111111
11111031111111111111111111111111
11111111111111111111111111111111
