32 18 1
0
11114444111111111111111111111111
12000000000000000000000000000041
10000000000000000000000000000001
11110000000000000000000000000001
14411111111111114444411111111111
10004444440000010000000000000001
10000000000000010000000000000001
14010000001000110000000000000001
14410000001000010000000000000001
10411000111100011111104411111111
10010000001000000000000010444001
10010000001000000000000010000001
10010000001111111111111110000001
10010000000000000000000000000001
10010000000000000000000000000003
14410000000000000000000000000000
11111111111111111111111111111111
11111111111111111111111111111111
