32 18
20000000000000000000000000000000
00000000000000000000011111111110
11111100000000000000000000000011
11111111000000000000000000000001
11111111110000000000000000000001
11111111111000011111000000000001
00000000001000010000000000000001
00000000001111110000000000000001
00000000000000000000000000000111
11110111000000000000000000001101
11100111110000000000000000111001
11100111111111111111111111100001
11101111111111111111111111111111
10000000000000000000000000000001
10000000000000000000000000000001
10000000000000000000000000000031
10000000000000000000001000000001
11111111111111111111111111111111
