32 18
00000000000000000000000000000000
00000000000000000000000000030000
00000000000000000000000000000110
00000000000000000000000000011101
00000000000000000000000001110000
00000000000000000000000011000000
00000000000000000000000011000000
00000000000000000000000110000000
00000000000000000000001100000000
00000000000000000001111000000000
00000000000000001110000000000000
00000000000000111000000000000000
00000000000001100000000000000000
00200000000011000000000000000000
00000000001100000000000000000000
11111111110000000000000000000000
00000000000000000000000000000000
00000000000000000000000000000000
