32 18 1
0
11111111111111111111111111111111
14000400004000000000400000000501
10444000004000000000400000000501
10000000004000000000400000000501
10000000000000000000000000000501
10000000000000000000000000000501
10000000000000000000000000000501
10000005000011111110000000000501
10000000000000200000000000000501
10000000000000000000000000000501
10000000000000000000000000000501
10000005001111111111100000000501
10000000000000000000000000000501
10000005000000000000000000000501
10000005000000300000000000000501
10000005000000000000000000000501
11111111111111111111111111111111
11111111111111111111111111111111
