32 18
00000000000000000000000000000030
00000000000000000000000000000000
00000000000000000000000000111111
00000000000000000000000000000001
00000000000000000000000000000001
00000000000000000000011111000001
00000000000000000000000000000001
00000000000000000100000000000001
00000000000000001000000110000011
00000000000000001001111110000111
00200000000000011001000000001111
00000000000111110000000000011111
11111110000100000000000000111111
00000010001100001100000001111111
00000010011100000000111111111111
00000011111111100000100000000001
00000011111111111111100000000000
00000000000111111100000000000000
