32 18
00000000000000111100000000100000
00000000000001111110000001110000
10000000000000000000000011111000
13000000000000000000000000000000
10000000000000000000000000000000
11000000000000000000000000000000
11100000111111000011110000000000
11111111111100000000000111100000
00000000000000000000000000000000
00000000000000000000000000000111
00000000000000000000000000001111
02000000000000000000000011101111
00000000000000000011110011101111
11111111000111110011110011101111
11111111000111110011110011101111
11111111000111110011110011101111
11111111000111110011110011101111
11111111000111110011110011101111
