32 18
11111111100000011111100000000000
11111110100000011110000000000000
11111000100000011110000000011000
11110000100000011110000000011110
11110010100000011110001110000110
11100010100000011110000000000110
11000100101100001111000000011110
11001000100100001111100000000010
10011000100111001111100000000010
10011101110100001111110000000010
00011100000110001111100000000010
00111100000110111111100011100010
20111111011110001111100000000010
00111111111110001111100000000010
11111111111111101111100011111110
11111111111111100000000011111100
11111111111111100000001111111130
11111111111111111111111111111111
