32 18 1
0
00000000000000000000000000000000
00000000000000000000000000000000
00000200000000000000000000000000
00000000000000000000000000000000
00000000000000000000000000000000
00001110000000000000000000000000
00000000000000000000000000000000
00000000000000000000000000000000
00000000111000000000000000000000
00000000000000001000000000030000
00000000000000001000000000000000
00000000000000001000000000000000
00000000000011111000000000010000
00000000000000000000011000000000
00000000000000000000011000000000
00000000001111111100000000000000
00000000001111111100000000000000
00000000001111111100000000000000
