32 18 1
0
00000000000000000001444444410000
00001100000000000001000000010000
00000000110000000001000000010000
11000000110000000001000000010000
00000000110000005001000000010000
00001100110000000501000000010000
00000000110000000051000000010000
11000000110000000005000000000000
00001100110000000000500000000000
00000000110000000000050000000000
11000000110000000000005000000000
00000000110000000000000500000000
00001100110000000000000050000000
20000000110000000000000005000000
00000000110000000000000000000000
11100000110000001111000000000000
00000000110000000000000000000003
00000000110000000000000000011111
