32 18 1
0
00000000200000000000000000000000
00000000000000000000000004040000
00000000000100404000000004040000
00000500050100404000000400000400
00000050500100404000000040004000
00000000000140000040000004440000
00000555550004444400050005000000
00000000000000000000005050000011
00000000000000000000000000000000
00000000000000000000055555000000
00000400400000000000000000000003
00000400400000000000000000000000
00000400400100000000000000000011
00044000044100000000100000000000
00004400440100000000100000000000
00000444400100000000100000000011
00000000000100000000100000000000
11111111111111111111111111111111
