000000000000000000000000000000
001110000000000000000000000000
001111000000000000000000000000
011111000000000000000000000000
011111100000000000000000000000
111111100000000000000000000000
000000000000000000000000000000
000000000000000000001110000000
000000000000000111000000000000
000000000000011111000000111000
111111111111111111000000000000
111111111111111111000000000111
111111111111111111000000000000
111111111111111111000000000000
111111111111111111000000000000
